F0./assets/floor_dirt.xpm
       C ./assets/floortile.xpm

NO ./assets/Wall_North.xpm
WE .assets/Wall_West.xpm
EA ./assets/Wall_East.xpm
SO ./assets/Wall_South.xpm

D ./assets/door.xpm

111111111111111111111111111111111111111111
100111111111111000000000000000000000000001
1001111111111110000000000000000000000000011
11111111111111111111001111000000000000000011 
                   1001 111111111110100101011111111111
   1111111111111   1001 100000100010100000000000000111111111111111111111111111111111111111111111111
   1111111111111   1001 100000100010100100010000000000000000000000000000000000000000000000000000001
   1111111111111   1001 100000100010100000000000000000000000000000000000000000000000000000000000001
   1111111111111   1001 100000110110100101010000000000000000000000000000000000000000000000000000001
   1111111111111   1001 100000000000000000000000000000000000000000000000000000000000000000000000001
   1111111111111   1001 101111000000000000000001110101010000000100110000000000000000000000000000111
   1111111111111   1001 101  10000000000000000010100000000101010101010000000000000000000000000001
   1111   111111   1001 101  10000000000000000010000000000000000000000000000000000000000000111111
   1111111111111   1001 1011110000000000000000ED00000000000000000000000000000000000000000001
   1111111111111   1001 10000000000000000000000100000000000000000000000000000000000000000001
   1111111111111   1001 1000000000001D1000001D1100000000000000000000000000000000000000000001                              1111
   1111111111111   1001 1111111110001D1000011D1100011111D111000000000000000000000000000000011111111111111111111111111111111001111
   1111111111111   1001 1101000010001D10000D000D0000D0000001000000000000000000000000000000000000000000000000000000000000000000D01
   1111111111111   1001 1100000010001D1000011D11000111111111000000000000000000000000000000000000000000000000000000000000000001111
                   1001 1101000010001D1000001D10000000000000000000000000000000000000000000000000000000000000000000000000000001
                   1001 1101111110001D1000000000000000111111111111111111111111111111000000000000000000000000000000000000000001
1111111111111111111100111100000000001D1000000000000000000000000000000000000000000000000000000000000000000000000000000000000001
1000000000000000000000000000000000001D1000000000000000000000000000000000000000000000000000000000000000000000000000000000000001
111111111111111111111111111111111111000000000000000001111111111111111111111111111111111111111111111111111111111111111111111111
                                   10000000000000000011
                                   110000000000000000011
                                    11000000000000000001
                                     1000000000000000001
                                     1000000000000000001
                                     1000000000000000001
                                     1000000000000000001
                                     1111111111111111111
